0000000011111222100000
0056700001112221113111
0004000000012201111111
0000000022222000000000
1010000023220000000000
1111111122201000006000
0103111122111110054700
0000011222111110000000
