GGGGFFWWGGG
GGGGFFFWFGG
GTGGFFWFFFF
GLRGGFWWFHF
GCGGGFWFFFF
GGGGGGWGFFF
GGGGWWGGGGG
GGGGWWWGGGG
GGGGHWGGGGG
FFGGWWGGGGG
FFFFWGGGGGG
FFFFWWFGGTG
FHFFWFFGLRG
GGFFWFFFGCG
GGFWWFFGGGG
GGGFWWFFFGG
